....................
.##.......#.........
.#........#.........
##........###.......
...............###..
....................
........#.......###.
........#...........
........###.........
..........#.........
..........#.........
....................
......###...........
........#...........
........###.........
....................
.###..........#.....
..............#.....
..............######
....................